LevelName Level3
Difficulty 3
LevelBoard
###########
#ooo #    #
#o#  #@   ##
#        @ ##
#@   #	  @ #
#A      #   #	   
#############