LevelName Level2
Difficulty 2
LevelBoard
#########
#       #
#  @   ##
#A   o o#
#  @   ##
##      #
#########