LevelName Level1
Difficulty 1
LevelBoard
##########
# # # # ##
# o    @A#
# # # # ##
##########